. . . . . . . . . . . . . . # . . # . . . . . . . . . . # # . # # # # . . . # . . . . . . . . # # .
. . . . . # . . . . . . . . # # . . . . . # . . . . . . . . . # . . . . . # . . # # . . # . . . # .
. . . # # . . # . . . . . . . . . . # . . . . . . # . . . . . . . # . # . . # . . . # # . . . . . .
. . . . # . . . . . . . . . . # . . . . . . . . . . # . . . . . . . . . . . . . . . . . . . # # . #
. . . . . # . # . . . . . . # . . . . . . . . . . # # . # . . . . . . . . . . # # . # . . # . . . .
. . . . # . . . . . . # # . . . # . # . . # . . . . . . . # . . . # . . . # . . # . . . . . # # . .
. . . . . # . . # . . . . . . . . . . . # . # . . # . . . . . # . . . # . . # . # . . . . . # # . #
# . . . # . . . # . . . . . . . . # . . . . . . . . . . . . . . . # . # . . . . . # . . . . . . . .
. # . . # # # . . . # . . . . . # . . . . . . # . . . . . # . # # . # . . . . . . . . . # . . . . #
. # . . # . . . . . # . . . # # . . . . # . . . . # . . . # # . # . . # # . . . . . . . . . # . # .
. . . . # . . . . # . . # . . . . . . . . . . . . # . # . . . . . . # # . # # . # . # . # . # # . .
# . # . . . . . . . . . # . # # . # # . . . . . . . # # # . # . . . . . . # # . . # . . # . # . # #
. . # . . . # # # . # . . . . . . . . # . . . # . . . . . . . # . . . . # . . . # # . . . # . . . .
# . . # # . . . . . # . . . . . . # . . . # . . . # . # # . . # . . . . . . # . . . . . # . . . . #
. . . . # . . # # # . # . . . # . . . . . . # . # # . . . . # . . # . # . . . # . # . . . . . # # #
. # . . # # . # # . . . . . # . . . . . . . . . . # . . . . . . . . . . . . . . . . . . . . . # . .
. . . . . . . # . . . . . . . . . . . . . . # . . . . . . . . . # . # . . # . . # # . . . . # . . .
. . . # . . # # . . . # . . # # . . . . . . # . . . . # . . # . . # . # # . . . . # # . . . . # . .
. . . # # # . . . . . . . # . # . . . . . . . # . # . . # . . . # . . . . # . # # . . . . . . . # .
# . . . . . . # . . # # # . # . . # . . . . # . . . . . . # . # . . . . # . . . # . . . . . . . . .
. . . # . # . . . . . . . . # . . . . . . . . # . . # . # . . . . . # . # # # . . # . . . . . . . .
. . . . . . . . . . . . # . . # . # # . . . . . . . . . . . . # . . # . . . . . # # . . # . # . # .
. . . . # . # . . . . # # . # . # . . # . . . . . . . . . . . . # # . . . . . # # # # . . . . . . .
. # . . # . # . # . # . . # . . . . # . . . . . . . . . . . . . . # # # . . . # # . . . # . . # . .
. . . . # . . # . . . # # . . . # # . . # # . . . . . # . . . . . # . . # # . . # . . . . . # # . .
. . . . . . . . . . . . . . . . . . . . . . . . . . . . . . . . . . . . . . . . . . . . . . . . . .
# # . . . . . . . . . . . . # . . # # . . . . . # . . . . # . . . # . . . # # . # # . # . # . . . .
# # . . . . . . . . # . . . . . # . . . # . . . . . . . # . . . . . . . . # # . # . . # . # . # # .
# . . # . # . . . . . . . # . . . . . # # . . . . . . . . . . . . . # . . . . . . . . # . . # # . .
. # . . . # # . . . . . . . . . . # . # # # . . . . # . . . # . . . . . . . . . . . . # . # # . . .
. # # . . . . # # . . # . . . . . . . . . . . # . . . . . . . . # . . # # . . . . . . . . # . . . .
# . # . # . . . . # # # . # . . . # . . . . . # # . . # . . . . . # . . . . # . . # . . . . . . # #
. # # # . . . . # # # # # . . . . . # . . . # # . # . . . . . . . . # . . . . . . . . # . . . . . .
. . # # . . . # . . . . . # . . . . # . . . # . . # # . # . # # . . . . # . . . . . . # . . . # . .
. . . . # . . # . . . . # . . . # . . . . . . # # . . . # . . . # . . . . . # . # . . . . . # # . .
. . # . . . # . # . # . # . . . # . . # . # # . . # . . # . . . . # # . . # . . . . # # . # . . . .
. # # . . . . . . # . . # . # # . . . . . . . . . . . . # # . . . . . # . . . # . . . . . # . # # .
. # # . # # . . . . . . . . . . . . . # . . . . . # . . . . . # # # . # # . # . . . . # # . # . . #
. . # . . . # . . . . . . # # . . . # # . . # . # # . . . . # . . . . . . . . . . . . # # . . . . .
. . . . . . . . . . # . . # . # . . . # . . # . . . # . . . . . # . . . # . # . . . . # . . . . . .
. . # # . . . . . . # . # . . . . . # # . # . . . # . . . # # . . # . . # . . . . . . # . . # . . #
. . . # . . # # . . . . # # . . # . . . . . . . . . # . . . . . . . . # . # # . . . # # . . . . . .
# . # . . . . # . . . . # . . # . . . . . . . . # # . . . # . . . . # . # . . . . . . . . . . . . .
. . . . # . . . # . . . . . . # # . . . . . . . # . . . . . # . . . . # # . # # . . . . . # # # . .
. . # # # . # . . . . # . # . . # . . . # # # # . . . . . . . # # . . . . . . . . . . . . . # # . .
# . . # . . . # # . . . . . . . . . # # . . . . . . # . . . . # . # . # . . . # . . . . . . . . . .
. . . . . . . . . . . . # . . . . . . . . . # . . # . . . . . . . # . . . . . . . # . # . . . . . .
# . . . . . . . . . . . . . . . . . . # . . # . # . # # # # . . . . # . . . . . . . # . # # . . # .
. . . # # . . . . . . . . . . . . . . . . # . . . . . # . . . . . . . # . . # . . . . . # . # . . .
. . . . . . . . . . . . . . # # . # # . . . . . # . . . . . . . . # . . . # . . . . . . . . . . . .
