. # # # . . . # .
# . # . . . # . #
. . . # . . # . .
. . . . # . . # .
. . . . . . . . .
. . . . . . . # .
. . . . . . . . .
. . . # . # # . .
. # # . . . # . .
