. # . # # . . . # . # # # # .
. . . . . . . . . . . # # . .
. . . . . . . # . # . . . . .
. . # . . . . . # . . # # . .
. . . . . # . . . . . . . . #
. . . # # . . . . . . . . . #
. . . # . . . . # . # . . . .
. . . . . . . . . . . . . . .
# . . . # . . . . . # . . # .
# . . . . . . . . . # # . . .
. . . # . . . . # . . # . # .
# . . # . # . . . # # . # . .
. . . # . . . . . . . . . . .
. . . . . # . . . . # . . . .
. # . # . . . . # # . . # . .
