. # . . #
. . . # .
. . . . .
. # . . .
# # . # .
