. # . . . # # # . . . . # # # # . . . .
. # # . # . # . . # # . . # # . . # # .
. . . . # . . . # # . . . # # . # # . .
# . # . . . # # # # . # . . . . . # # .
# . # # # . . . # . . # . # . # . . # .
. . . . # # # . # . # # # # . # # . . .
# . # . # . . . . . . # . . . . . . . .
. . # . . . # # # # . . . . . . . . . .
# # # . # . # . . . # # . . . . . . . .
# . . . # . . . # . . . . . . . . . . .
# # . # # # # . . . . . . . . . . . . .
. # . . . . # # # . . . . . . . . . . .
. # . # # . # . . . . . . . . . . . . .
. . . # . . # . . . . . . . . . . . . .
# # # # . # # . . . . . . . . . . . . .
. # # . . # . . . . . . . . . . . . . .
. . . . # # # # . . . . . . . . . . . .
. # . # # . . . . . . . . . . . . . . .
. # . . . . # # . . . . . . . . . . . .
. . . # # # # . . . . . . . . . . . . .