. . . . . . . # . . . # . . . . # . . # . . # . . . . . . # . . # # . . # . # .
. . # . . . # . . . # . # . . # . . . . # . . . . # . . . . # # # # # . . . . .
. . . . # . . . . . . . . . . # . . # # . # . # # . . # # # . . # . . # . . # .
# . . . . # . . . . . . . . . # . . . # . . . . # . . . . # . # . . . . . # . .
. . # . . . . # . # . # . . . . . # . . . . . . # # . # . . . . . # . # . . . #
. . . . . . . # . # . . . # . # # . # # . . . . . # . . # . . . . . . . . . . #
. # # . . . . . . . . . # # . . . . . . # . . . . . . # # . . . . . # . # . . #
. . # . . . . . # . . . . . . . # . . . . # . . # . . . . . . . # . . . . # # .
. # # . . # . . . . . . . . . . . # # # . . . . # . . # . . . . # . . . . . . .
. # . . . # . # # . # # # . . . # . # . # . . # # . # . # # . # . . # . . # # .
. . . . . # . . . . . # . # . . . . # . . . # # . # . . . . . . # . . . . . # #
. # # . . . # . . . # . . . . . . . . . . . # . . . . . . . . . . . . . # . . .
. # . # . . # # . . # . . . . . # . . # # . . . . . . . . . # # . . . . . . . #
. # . . . . . . # . . # . . . . # . # . . . . # . . . . . . . . . . . # . . . .
# . . . . . . . # . . # . . . . # . # . . # . . . . . . . . # . . . . . # # . #
. . # # . . . . . . . . . . . . # # # . . . . . . . # . . . . . . . . . . . # .
. . . # # . . # # # # # . . # . . . . . . . . # # . . . . . # . . . # . . . . #
# . # . . . . . . . . # # . . . . . . # # . . . . . . . # # . . # # . . . # . #
. # . # . . . . # . # . # . . . # # . . . . . . # . . . . . . . . . . . . . # .
. . . . # . . # # # # . . . . # . # # . . . . . . . . . . . . . # . # . . . . .
. . . . . . . . . . . . . . . . . . . . . . . . . . . . . . . . . . . . . . . .
. . . . . # # . . # # . . . . . . # . . . . . . . # . # . . # # . . . . . . . .
. # . . . # . . . . . # . . # . # . . . . # . . . . . . . . . # . . . . . . . .
. . . . # . . # . . . # . . # . . . . . . . . . . . . . . . # # . # . . . . . .
. . . . # . # # . . . # . . # . . . . # . . . . . # # # . # # . # # . . . . # .
# . . . # . # . . . . # . # # . # # . # # . # # # . . # . . . . . . . # . # . .
. . . # . . . . . # # . . . . . . . . . . . . . . . . . . # . . . . # . . . . .
. # . . . # # . . . . . # . . . . . . . . . . # . . . . . . . . # # # . . # . .
. . . . . . # . # . # . . . . . # . . . . . . . . # . # . # . # . # . # . . . .
. . . . . . . . # . . # . . . # # # . # # . # . . . . # . . . . . . . # . . # #
. . . . . # . . . . . . . # . # # . # . . . . . # # . . . # . . . . # . . . . .
. . . . # # . . . . . . . . # . . # # . . # . # . . . . . . # . # # . . . # . #
. # . . . . . . . # . . . # . # # . . . . # # . . . . . . # # . . . . . . # . .
# . . . . # # . . . . # # # . . . . # . # . # # # . . . . . . . . . . . . . . .
# # . # . . . . . . # # . . . . . . . . . . # # . . . . # . . . . . . . . . . .
. . . . . . # # . . . . . # . . . # . . . . # # # . . # . . # . . # . . # . . #
# . . . . # . . . . . . . . . . . . . . # . . . # . . . . . . # . # . . . # # .
# # . # . . . . # # . # . . . . . . . # . . # # . # . # . . . # # . . # . . . .
. . . # . . # # # . . # . # # . . . # . . . . . . . # . . . . . . . . . . . . .
. . . . . . . # . # # . # . . . . . . . . . . . . . . . . # . . . . . . . . . .
