. # . . . # # # . . . . # # # # . . . .
. # # . # . # . . # # # . # # . . # # .
. . . . # . . . # # . # . # # . # # . .
# . # . . . # # # # . # . . . . . # # .
# . # # # . . . # . . # . # . # . . # .
. . . . # # # # # . # # # # . # # . # .
# . # . # . . . . . . # . . . . # # # .
. . # . . . # # # # . . . # # . # . # .
# # # . # # # . . # # # . # # . # . . .
# . . . # . . . # # # . . . # . # # . #
# # . # # # # . . . # . # . # . # . . #
. # . . . . # # # . # # # . # # # . # #
. # . # # . # . # . . . # . . . . . . #
. . . # . . . . # . # # # # # . # # . #
# # # # . # # . # . # . . . # . . # . #
. # # . . # . . # . . . # . # # . # # #
. . . . # # # # # # . # # . . . . . . #
. # . # # . . . . # . # # # # . # . # #
. # . . . . # # . # . . . # . . # . . .
. . . # # # # . . # # # . # . # # # # .