. # . . .
. . . . .
. . . . .
. . # . .
. . # . .
