. . . . # . . . . . . # . . . . . . . # . . . # # . # . # #
. . # . . . . . # # . . . . # . . . . . . . # . . . # . . .
. . . . # . . . # . # . . . . # . . . . . . . . . . . # # .
. . . . # . . . . . . . . . . . # . . . . . . . # . . . . .
. . . . . . . # # . . . . # . . . . . . # . # . . . . # . .
# . . . . . # # . . . . . . # . # # # . . . # . . . . . # .
# . . . . . . # # . . . # . # . . . . . # . . . . . . . . #
. . . . # . . . # . . # # . . . . . . # . . . . # . . . # .
# . # . . . . . . . . . . # . . . . . . # . . . . . . # . .
. . . . # . # . . . . . . # . . . . . . . . # . . . . . # .
# . . . . . # . . # . . # . . # . # . . . . . . . . # # # .
. # . # . . . # . . # . . # . . . # # . . . . # . # . # . #
. # . . . . . # . . . . . . . # . . . # . . . # . . . . # #
. # . # # . # . . . . . . . . # . . . . # . . . . . # . . .
. . . . . . . . . . # # . . . # . . # # . . . . # . . . . .
. . . . . . . . . . . . . . . . . . . . . . . . . . . . . .
. . . . . . # . . . # . # . # . . . . . . . # . . . . . . #
# . . . . . # # . . # # . . # . . . . . . # . . . . . . # .
# . . . . # . # . . . # . . . . . # . . # # . . . . . . # .
. # . . . . . . . . # . . . . # # . . . . . # . . . . . . .
. . . . . . . . . . . # . . # . . . . . . . . # # . . # # .
. . . . . . . # . . # . . . # . . . # . . . . . . . . . . #
. . . . . # . . # . . . # . . . . . # . # # . . . # # . # .
. # # . . # . . . . . . . . # . . . # # # . . . . . # . . .
# . . . . . . . . . . . # # . . . . . . . . . # . # . . . .
. # . . . # . . # # . . . . . # # . . # . # . . # . . . . .
. . . . . # . . . . # # # . . . # # . . . # . # . . . . . #
# # . . . . . # . . . . # # # . . . . . . . . # . . . . . #
. . . . . # . . # . . . . . . . . # . . . . # # . # . . . .
# . # # # . . . . # # . . . . . # # # . # # . . # . # . . .
