. # . . . # # . . . # # . . . . . . . . . # . . . . . . # # . # # . # . # . . . . . . . . . . . . . . # . . # . . . . # # . . # . . . . . . . . . # . # # . # .
# . . . . . . . . . . . . . . . . . . . . . . . # . . # . . . . # # # . # . # . . # # . . . . . . . # . # . . . . . # . # . # . . # # # . . . . . . . . . . # .
. . . . . # . # . . . # . . # # . . . # . # . # . # . . . # # . . # . # . . . . . # # # . . . . . # . # . # . # # . . # # . # . . . . . # . . . # . . # . . . .
# . . . # . . . . . . . # # . . . . . # . . . . . . # . # . . # . # . # . . . # . . # . # . . . . # . # . . # . . . . . . . # . . # . . . # . . . . # . . . . .
. # . . . . # . # . . . # . . . . # . . # . . . # # . . # . # . # . # . . . # . # . . . . . . . . . . . . . . . . . . . . . . . # . . . . . . . . . . . . . # .
. . . . . . . . . . # # # . . . # . # . . . . # . . . . . . . . . # # # . . . . # . # . . . . . . . . # . . # . . # # # . . # . . . . . . . # . # . . . . . . #
. . # . # . . . # # . # . . . # . # . . # # # . # # . . . # . . # . . . # . # # # . . . . # # . . . . . . # . # # . # . . . . . . . # . . . . # # . . . . # . .
. # # . . . . . . . . . . . . # . . . . . . . . . # . # . . # . . # . . # . . . # . . . # . . # . . . . . . # . . # . . # . . # . . . . # . . . . # . . . . . .
# . # # . . . . . . . . # # . . # . # . . . # # . . . # # . . . . . # . . . . . . . . # . . . . . . . . . . . . . . # . . # . # # # . . . . . . . . # . . # . .
. . . . . . . . # . # . . # # . # . . # . . . . . . . . . . . # . . . . . . . . . # . # # . . . # . # . . . . . . . . . # . . . . . . # # . # . . . # . . . . .
. . . # . . # . . . . # . . # . . . . . # # # # . . . . # . . . . . . . . . . . . . . # . . . . . . # . # # . . . . . . . . . # . # . . . # . . . . . . . . # .
. . # . . # # # . # . . . # . # . . . # . . . . . # # . . # . # # . . . . . # . # # . . # . . # . . . . . . . . . . . . # . # . . . . . . . . . . . # . . . . #
. # # . . . . . # # . . . . # . . # . # . . . . . . . . # . # . . . . . . . . . . . . . # # . . . . . . . # # # . . # . . . # . . . . . . # . . . . . # . . . .
# # . # . # . . # . . . . . . . . . . # . . # . # . . . . . . . . . . . . . # . . . . . . . # # . . . . . # . # # # . . . . # . . . . . . . . # . # # . . . . .
. . # . . . . . . . . . . # . # . . . . . # # . . . . . . . . . . . . # . . . # . . # . . . . . . . . . . . # . . . # . # . # . . . # . . . . . # . . # . . . .
. . . . . . . . . . . # . . # . . . . . . . # . . # # . . . . . . . # . . # . . # . . . . . # . . . # . . . . . . . # . # . . . . # # . . . # . # . . . . . . .
# . . . . . . . . . # . . . . . . . . . . . . . . # . . # . # . . . . . . # . # . # # . # . # . . . # . # # . . . . . . . # . . # . . . # . # # . . # . # . # .
# # # # . . # # . . . . . # . . . . . . # . # . . # . # . # . . # # . . # . # . # . . # . # . . . . . # . . # . . # . . . . . . . . . # # . . . # . . . . . . #
. . . # # . # . . # . . # . . . . . . . . . . . . # . # . . . . # . . . # . # . # . . . # # # . . . . # . . . . . . . . . . . . # . . # . . . . . . . # . . # .
. . . . . # . . . # . . . . . . # . # . # # . . . . . # # . # . . . . # # . # . . . . # . . # . . # . . . . . . # # # . . . . # . . # # . . . . . . . . . . . #
. . # . . # . . . . . . # . . . # . . # . # . # . . # . . . . . . . . . . . # . . . . # # . . . . . . . . . . . . # . # . . . . # . . . . . . # . # # . . . . .
. # . . . # # . # # . . # . . . # # # . # . . . . # . . . . . . . . # # . . # . . # . . . . . . # . # . . . . . . . . # . . . # . # . # # . # . . . # # . . # .
. . . . . . . . . . # . # . # . . # . # # # . . . . . # . . . . . # . . . # . # . # . . . # . . . . # . . # . . . . . . . . . . . . . . # . . # . . . . # # # .
# . . . # . . # # # . . # . . . # . . . . . . . . # . . . . # . . . # . . . . . . . . . . . . . . . # . # . . . . . . . . . . . . . . # . . . # # # . # # . # #
. . . . . . # . . . . . # . . . # . . . . . . # . . # . . . . . . . . # # . . . . . . . . # . . . . . . . . # . . # . . . . . . # . # . . . . # . . . # . . # .
# . . . . . . . # . . . . . . . . . . . . . . . # . . . . . . # # . . . . # . # # . . . . . . . . . . . . . . . # . . . # . . . # # # . # . . . # # . . . # . #
. . . # . # # . # . . . . . . . . . . . . . . . . . . . . . . # . . # . . # # . . # # # . . . # # . . # # . . . . . . . . # . . . . . . # . . . . . # . . . . .
# . # . # . . . . . # . . . . . . . . . . # . . . # . . . . # . . . . # # # . # . # # . # . . . . # . . # . . . . . # . # . . . # . # # . . # . . . . # . . # .
. . . . # . # . # . . # . . . . . # . # # . . . . . # . . . . . # # # . . . # # # . . . . # . . # # . # . . # . . # . . . . . . . . . . . . . . . . . . . # # #
. . . . . . . . # . . . . # . . . . . . . . . . . # . . . . # . . # . . . . . . . . . . . . . . . . . . . . . . . # . . . . # . . . . # # # . . . . . . # . . .
. . . . # . . . . . . . # . . . . . # # . . . . . . . . . . . . . . . . . # # # . # . # . # . . . # . . . . . . . . # . # . # . . . . . # . . # . . # . # . . .
. # # . . . # # . . . . . # . . # . . # . . . . # # . . . . # . . . # . . . . . . . . . # . . # . # . . . . . . . . . # . . . . # . . . # . # # # # # . # # # .
. . . . . . . . # # . . # . . . # . . . . . . . . . . . . . # . . . . . . # . . . . # # . . . . . # . . # # . . # . # . . . # # . . . . # # . . . . . . . . # .
# . . . . # . . . . . # . . . # . # . . # . # . . # . # . . . . . . . # . # . . # . . . . . . . . . . . . . . # . # . . . # # # # # . . . . . . . # . . . . . .
. # . . . . # . # . . # # . # . . . . # . . # . # . . # . # . # . # . . . # . # . # # . # # # # . # . # . . . . . . . # . . . . # . # . . . . # # . . . . . . .
. . . . . . . # . # . . . . # # . # . . . . . . . . # . # # . # . . # . . . . . . . # . # . . # # . . . . . . . . # . . . . # . . # . # . # . . . . . . . . . .
# # . . . . . . . . . . . . . # . . # . . # # . . . . . . . . . . . . . . . # . . # . . # . # # . . . . . . . . . . # . . . # . . . . . . # . . # . . . # # . .
. # . . # # . . . . . . . . # . . . . . . . . # # . . . # . . . . . . # . . . . . # # . . . . . . . # . . . # . . . . # . . # . # # . . . . . # . . . . # . . .
# # . . # # . . . . . # # . . . . # # . . . # . . . . . . # . . # . . . . . . . . . . . . # . # . # . . # . # . . # . . . . . . . . # . # . . # . . . . # . # .
. . # # . . . # # . . . # . . . . . # . . . . . . . . . # . . . . . . # # . . . . # . # . . . . # . . . # . . . . . . . # . # # . . . # . # . . . # . # . . . .
. . . . . . . . . . . . . . . . . . . . . . . . . . . . . . . . . . . . . . . . . . . . . . . . . . . . . . . . . . . . . . . . . . . . . . . . . . . . . . . .
. # # . # . . . . . # . . # # . . . . # . # . . . . . # . # . . . # . . . . . . # . . . . . . . . . # # . . . . . . . . . . . . . . . . . . . . . . . . . # . .
. # # . . # # . . . . . . # # . . . . # # . . . . . # . . . . # # . . # . . . . . . . # . # . . # . # # # # . . # . . # . # . # . . . # . # # . # . . . . . . .
. . . . # . # . . . # . . . . . . . . . . . # . . # # . . . # # . . # . . . . # # . . . . . . . . . . . . # . . . . # # # # . . . # # . . . . . . . . . . . . .
# . # . # . . . # . . . . # . . # . . . # . # . . . . # . # . . # . . . # . . # . . . . . # # . # . . # . . . . . # . . . . . . # . . # # . . . # # . . . . # #
. # . . . . . . . . . . # . . . . . . . # # . . . . . . . . . . . . . . . . . # . . . . . . . . . . . . . . # . # . # . . . . . . # . # . # . # # . . . . . . .
. . . . # . . . # . . . . . . . # . . . # . . . # . . . # # . . . . # . . . . . . . . # . . . . . . . . . . . # . . # . # . . . . . # . . . . . . . . # . . # .
. . . . . # # . . . # . . . . . . . # . . . . # . # # . . . . . . . . # . . . . . . . . . . . . . . . . . . . . # . . . . . . # . . . # . # . . . . # . . . . .
# . # . . . . . . # # # # . . . . . # . . . . . . . # # . . . # # # . . . . . . . # . . # # . # . . . . . # # . . . . # . . # . . . # . . # . # . . . . . . # .
. . . . . . . # . # . . . . . # # . # # . . # . # . # . . . . # # . . # # . . # . . . . . . . . . . . . # . . . . # . . . . # . . . . . . . . . . . . . . . . #
. . . . . . # . . . # # # # . # # # . . # . # # . . . . . . # . . . . . . . . . . . # . . . # . . . . . . . . . . . # . . . . # . . . . # . . . . . . . . . . .
. # . . # . . . . . . . # . . . . # . . # # # . # # # . . . . # . . . . . . . # . . . . . . . # . . . . . . . # . # . . # . . # # . . # # . . . . # . . . . # .
# . . . . # . # . . # # . # # # # . . # # . # # . . . . # . . . . # . . . . . # . . . # # . . . # . . . . . . . . . . . # . . . # . . . . # . . # # . . . . . .
# . . . # . # # . . # # . . # # . . . # . . . # . . . . . . . . . . . . . . . . . # # . . . # . . # . # . . # . . # . # # . # . . . . . . # . . # # . . # . . #
. . # . . . . . . . # . . . # . . . # . # . . # . . . . # . . . . # . # . . # # . . . . . . # # # . . . . # . # # . . . . . # . . # . . . . # . # # . . # . . #
# # # . . . . . . . # . . . . . . . . . . . . . . # . . # . # . # . . . . . # . # # . . . # . . . # # . . . . . . . # . # # . . . . . . . . . . # . # # . # . .
. . . # . . # . . . . . . # . . . . . . . . . . . . . . . . . . # # # . . . . . # # . . # # # . # . . . . . . . . . . . # . . . . . # . # . # # . . . . . . . .
. . # . . . . . # . . . . . . # . . . # . . . . . # # . # . . . # . # . . # . . # . . . . . . . . . . # . . # # . . # # . # . # . # . # . . . . . . . . # . . #
. . . # . . . . . . # . . . . # # . . . # . . . . . . . . . # # . # . . . . # . . . # . . # . . . # . . . . . # # . . # # . . . # . . . . . . . . . . # . . . .
. # . . . # # # . # . . . . . . . # . . . # . . . # # . # . . . . . . . . . . . # . # . . . # . # # . # # . . . . . # . . . # . . . . . # . # . . . . . . . . .
# # . . . . . . . . . . . # # . . # . . . . . . . . . . . . # . . . . # . . . . . . . # # # . # . . . . . . . . . . . . . # . . . # . # # . # # # . . . . # . #
. . # . . . # . . . . # . # . . # . . . . . # . . . # # . # . # . # . # . # . . . # . . . . # # . . # . . . . . . . . # . . . . . . . # . # . . # . . . # . . .
. . . # . . . . . # . . # . . # . . . # . . # . . . . . . . . # . . # # . . . . . . . # . . . # . . . . # # # . . . . . . . . # # # . . # # . . . . . . # . . .
. . # . # . . . . . . # # # . . # . . . . . . # # . . # # . . # . . . . . . . . . . . . # . . # . . . . # # . . . . . . . . . . # . . . # . . . . . . . . . . .
. # . . . . . # . # . . . . # . . . . . . . . # . . # . . . . . . . . . # # . . # # . . . . . . . # . . . . # . . . # # . . # . . . . . . . # . # . # # . . # #
. # . . . # # . . . . # . . . . . # . # # # . # . . # . . # . . . . . . # . . . . # . . # . # # . . # . . . . . . . . # . . . . # . . # . . . . # . # . . . # #
. . # # # . . # . # # . . . # . . . . # # . # . # . # . . . . . . . . . # . # . . . # . . . . . . . . # . . . . . . . . . # . . . . . # # . # # . # . . . . . #
. # . . . . . . . . # . . . . . . . . . . # . # . . # . . # . . . . . . # # # . # # . . . # . . . . # . # . . . . # # . . . . . # # . . # . . . . . # . . . # .
. . . . . # . # # # . . # . . . # . . . . . # # . . . . . # . # . . . # . . . . . . . . . . . . . . . . . # . . . . # # . . . . # . . . . . # . . . . . . . # #
. . . . . # . . . . . # # # # . . . . . # . . # . # . . # # . . . # . . . . . . # # . . . . . . . . . . . . . . . . # . . # . . # . . # . . . . . . . . . # # .
. . . # # . . . . . . # . # . # . . # . . . # . # . . . . # . # . . # . # . . . . . . # . . . # . # . . # # . . . . . # . . . # . # . . . . . . . . . . . . . .
. . . # . . # . . . . . . . . . . . . . . . # . . . . . . . . . # . . . . . # # . . # # # . . . . . . . . . . # . . # # . . . . . # . . # # # . # . . . . . . .
# # . . # . . . . . . # . . # . . # # # . . . . # # . . # # . . # . . . . . . # . # # # . . . . . . . . . . . # # . . . . . # . . # . . . # . . . . # # . . . .
. . # . . . . # . . . . . . # . . . . . . . . . . . . # . . . # . . . # . . . . . # . # . # . # . . . . . . . . . . # # . . # . # # . . . . # # . . # . . . . .
# . . # . . # . . . . . . . . . . . # . . . . . . . . . # . . . # . . # . . . # . . . . . . . . # # . . # . . . # . # . # . . . . . # . . . . . . . . . # # # #
# . . . # # # # . # . # . . . . . # . # . . . . . # . . # . . . . . . # # # . . # . . . . . # . # . . . # . . . . # . # . . . # . . . # . . . . . . # . . . . .
. . . . . . # . # # . . . . # . # . . . . . . . # . # . . . . . . . . . . . . # . . . . . # . # . . . # . . . . . . . # # . . # . # . . # . . . . . # . . . . .
. # . . # . . . . . # . . # # # # # # . . . # . . . . . . . . . . # . . . . # # # . . . . . # # . # # . . # # . . # . . # # # . . . . . # . . # . . # . . . . .
# . . . # # # . . # . . . . . . . . . . # # . . . . . . . # # # # . . . . . . # . . . . . . # . . . . . . . . . . # # . . . # . . . . . # . # . # . # . . . . #
. . . . # . . . # . . # . # . . . . . . . # # . . . . . # . . . . . . . . . # . . . # . # . . # # . # . . # . # # . # . # # # . . . . . # # . . . . . # # . . .
