. # . # . # . # # .
. . . # . . . . # .
. . . . # # # . # #
. . . . . # # . . .
. . . . . . . . . #
. . . . . . . . . .
. # . . . . . . . .
. . # . . . . . # .
# . . . . . . . . .
# . . # . # . . . .
