. . # . . . . # . .
. . . . . . # . . #
. . . . . . . # . #
. # . . . . . . . .
. # . # . # # . # .
. . . . . . . . . .
. . . # . . . . . .
. # . . . . # . . .
. # . . . . . # . .
. # . . . # . . . .
