. . . . . . . . # . . # . . . . . . . . . # # . . . # # . .
. . . . . # # # . . . . . # . # . . . . # . . . . # . # . #
. . . . # . # . # # . . . # # . . . . . . # . . . . . . . .
. . . . . . . . . . . . . . . # . . . . . . . . . . . . # .
. . . . . . . . . . . . . # # . . . . . # # . # . . . . . #
. # # # # . . . # # . . . . . # # . . . # # . . . # . . # .
. . . . . # . # . . . . . # . # . . . # . . . . . # . . . .
. . . . # . # . . # . # # . . . . . . # . # # # . . # . . .
# . # # # . . . . # . . . . . . # . . . . . . . # . . . . .
. . . . . . . . . . . . . . # . # # . # . . . . # # . # # .
. . . . . . . . . . . . . . . . . # . . . # . . . . # . . .
. . # . . . . # . . . . . . . . # . # . . . # . # . # . # .
# . # . . . # # # # . . . . . . . . . . # . # # . . . # . #
. . . . . . . . . . . # . . # . . . . . # . . . . . # . . #
. # # . . # . . . . . # . . . . . . . . . . # . . # . . # .
. . . . . . . . . . . . . . . . . . . . . . . . . . . . . .
# # . . . . . . # . . . # # . . . . . . . . . . . . # . . .
# . . . . . . . . . . . . . # # . . # . # . . . . . . # # .
# . . # . # . . . . . # # . . # . . . . . # . . # . # . . .
. . . . . # # . . . . . . . . . . . # . . . . . . . . # . .
. # # . # . . # . . . . . # # . # . . . . . # . . # . . . .
. . . . . # . . . # . . . . . . . . . # . . # # . . # # # .
. # . . . . # . # . . . . . . . . . . . . . . . . . . . . .
. # . . . # . . . . . . . . . . . . # . . # . . # . . . . #
. . . . . . . . . # . . . . . . . . . . # . . . . . . . . #
. # . . . . . . . . # . # . . . . . . . . . . . # . # . # #
. # . . . . . # . # # . . . # . # . . . . . . . # # . . . .
. . . . # . . . . . . # . . . # . . . # . # # # # . . . . #
. . . . . # . . . . . . # . . . # . . . # . . . . # . . . .
. # # . . . . . # . . . # # . . . . . . # # . . . # . . . .
