. . # . . . . . . . # . # . . . . . . .
# . # . # . . . . . . . # . . . . # . .
. . . . . . . . . . # # . . . . . . # .
# . . . . . . . . . . # . . # . . . # #
. . # . . . . . . . . . . . . . . . . .
. # # # . . . . . . # . . . . . . # . .
. # . # . # . . . . . # . . . . . # . .
. . # # # # . . . . . . . . . # . . . .
. . # . . . . . . . . . . . . # . . # .
. # . . . . # . . . . . . . . . # . . .
. . . . . . . . . . . . . . . . . . . .
# # . . # . . . . . . . . . . . # . # #
. . . # . . . . . # . . . # . . # . . #
. . # . . . . . # # # # # . . . # . . .
. . . # . . . # . # . . . . . # . # # #
. # # . # . . # # # # . # . . . . . . .
. # # . . # # . # . # . # . . . . . . .
. # # . . . . # # . # . . . # . # . . .
. . . . # . . . . . . . . # . . . . . #
# . . . # . . . . # # . . . . . # . . .
