. . . . . # . # . . # # # . . . . # . #
. . . . . . . . . # # # # . . . # . . .
. . . . . . # . . # . # . . . . # . . .
. # . . # . . . # # . # . . . . . . # .
. . . . . # . . # . . . . # . # . . . #
. . # . . . . # . . . # . . # # . . # #
# . . . . . . . . . . . . . . . # # . #
. . . # . . # . # # # . # . . . . . . .
. . . . . . . # . . . . . . # # . # . .
. . # . . . # # . . . . . . . . . . . .
. . . . . . . . . . . . . . . . . . . .
. # . # . . . . # # # . . # # # . . . .
. # . . # . . . . . . . . . # . # # . .
. . . # . . # . . . # . . . . . . . . .
# . . # . . . # . . . . . # . . . . . .
. . . . . . . . # # # . . # . . . . . .
# . . . . . . . . . . . # . . . . # . #
. # . . . . . . # . # . . . . . . . . .
# . . . . . . . # . . . . # . . . . . #
. . . # . . . . . . . . . # . . . . . .
