. . # # # . . . # #
# . # . . . # . . #
. . . . # . # # . .
. # . # . . . # . .
# # . # . # . . # #
# . # . . # # . . .
# . # # # # . # . #
# . . . # . . . . #
. . # . . . # # . .
. # # # . # # # . .